111111111111111
101000000000001
101000110000101
101000001100001
100000001100001
1N0000000000001
111111111111111