111111111111111
101111111110001
101        1101
101 111111 1001
101 101011 10011111
1N1 11 101 10001111
111    111 1111
  11111101
  110 1101
  111 1111