1111111111111111111
1010000000000100001
1010001100009000001
1010000010000111101
1000000011111100001
1N00000000000000001
1111111111111111111