1111111111111111111
1010000000000100001
1010001100009000001
1010000010000111101111111
1000000011111100001111111
1N00000000000000001111111
1111111111111111111